Nome: (tetris)
*************************************###
######************######*************###
######************######*************###
***######************###******###****###
***######************###******###****###
************######***###***######****###
************######***###***######****###
************######*********###*******###
************######*********###**********
############*********************###****
############*********************###****
######******#########************###****
######**T***#########************###****
######******###***************######****
######******###***************######****