Nome: (corridors)
#########**********************#########
##************************************##
##*T********################**********##
##**********################**********##
##**********################**********##
****************************************
****************************************
*******#****######****######****#*******
*******#****######****######****#*******
########****######****######****########
****************************************
****************************************
*******#****#****#****#****#****#*******
*******#****#****#****#****#****#*******
****************************************