Nome: (battleinf!)
*******T********************************
****************************************
****#######***###******###***#######****
*****#####****####*****###***#######****
******###*****#####****###***###********
******###*****######***###***###********
******###*****#######**###***#####******
******###*****###*####*###***#####******
******###*****###**#######***###********
******###*****###***######***###********
******###*****###****#####***###********
******###*****###*****####***###********
*****#####****###*****####***###********
****#######***###******###***###********
****************************************