Nome: (cage)
****************************************
****************************************
****************************************
******############################******
******############################******
******############################******
******############################******
******###########**T***###########******
******###########******###########******
******############################******
******############################******
******############################******
****************************************
****************************************
****************************************